24
61
XXXXXXXXXXXXXXXXXXXXXXXXXXXXXXXXXXXXXXXXXXXXXXXXXXXXXXXXXXXXX
X                          S                                X
X                                                           X
X                                                           X
X                                                           X
X                                                           X
X                                                           X
X                                                           X
X                                                           X
X                                                           X
X                                                           X
X                                                           X
X                                                           X
X                                                           X
X                                                           X
X                                                           X
X                                                           X
X                                                           X
X                                                           X
X                                                           X
X                                                           X
X                                                           X
X                                                           X
XXXXXXXXXXXXXXXXXXXXXXXXXX F XXXXXXXXXXXXXXXXXXXXXXXXXXXXXX X